10 10 10 10 10 10 10 10 10 10 10 10 10 10 10 10 10 10 10 10 10 10 66 35 48 68 10 10 10 10 10 10 10 10 10 10 10 10 10 61 62 62 62 62 62 62 63 10
10 10 14 15 16 17 18 19 10 10 61 62 63 64 65 66 10 10 10 10 61 62 70 35 48 69 62 63 10 10 10 10 10 10 10 61 62 62 62 70 67 67 67 67 67 67 68 10
10 20 21 22 23 24 25 26 10 67 68 69 70 71 72 73 10 10 10 10 66 67 72 35 48 71 67 69 62 63 10 10 10 10 10 66 67 67 67 72 22 24 24 24 24 25 68 10
10 27 28 29 30 31 32 33 10 74 75 76 77 78 79 80 10 10 10 10 66 22 24 32 33 24 25 71 67 69 62 62 62 62 62 70 22 24 24 24 32 26 26 12 12 48 68 10
10 34 35 36 11 37 38 39 10 81 82 83 84 85 86 87 10 10 61 62 70 35 26 12 12 12 33 24 25 71 67 67 67 67 67 72 35 44 58 58 43 12 12 12 26 48 68 10
10 40 41 42 43 44 45 46 10 88 89 90 91 92 93 94 10 10 66 67 72 35 12 12 12 26 26 12 33 24 24 24 24 24 24 24 32 48 64 65 35 12 26 12 12 48 68 10
10 12 47 48 49 50 51 52 10 95 10 10 10 10 10 10 10 10 66 15 51 54 43 12 12 12 12 12 44 58 58 58 58 58 43 12 12 48 68 66 35 12 12 12 12 48 68 10
10 53 54 55 56 57 58 59 10 10 10 10 10 10 10 10 10 10 66 27 64 65 57 58 58 58 58 58 60 64 74 74 74 65 57 58 58 60 68 66 57 58 43 44 58 60 68 10
10 60 10 10 10 10 10 10 10 10 11 12 13 10 10 10 10 10 66 27 69 88 84 74 74 74 74 74 74 75 10 10 10 73 74 74 74 74 75 73 86 79 35 48 77 78 89 10
10 10 10 10 10 10 10 10 10 10 10 10 10 10 10 10 10 10 66 27 71 67 68 10 10 10 10 10 10 10 10 10 10 10 10 10 10 10 10 10 66 72 35 48 71 67 68 10
10 10 10 10 10 10 10 10 10 10 10 10 10 10 10 10 10 10 66 39 51 17 68 10 10 10 10 10 10 10 10 10 10 10 10 10 10 10 10 10 66 50 54 55 19 25 68 10
10 10 10 10 10 10 10 10 10 10 10 10 10 10 10 10 10 10 73 74 65 27 68 10 10 10 10 10 10 10 10 10 10 10 10 10 10 10 10 10 73 74 74 65 35 48 68 10
10 10 10 10 10 10 10 10 10 10 10 10 10 10 10 10 10 10 61 62 70 27 68 10 10 10 10 10 10 10 10 10 10 10 10 10 10 10 10 10 10 10 10 66 35 48 68 10
10 10 10 10 10 10 10 61 62 62 62 62 63 10 10 10 10 10 66 67 72 27 68 10 10 10 10 10 10 10 10 10 10 10 10 10 61 62 62 62 63 10 10 66 35 48 68 10
10 10 10 61 62 62 62 70 67 67 67 67 69 62 63 10 10 10 66 15 51 41 68 61 62 62 62 62 62 62 62 63 10 61 62 62 83 67 67 67 69 62 62 83 35 48 68 10
10 61 62 70 67 67 67 72 22 24 24 25 71 67 68 10 10 10 66 27 64 74 75 66 67 67 67 67 67 67 67 69 62 70 67 67 81 22 24 25 71 67 67 81 35 48 68 10
10 66 67 72 22 24 24 24 32 12 26 33 24 25 69 62 62 62 70 27 68 10 10 66 15 51 51 51 51 51 17 71 67 72 22 25 82 35 12 33 24 24 25 82 35 48 68 10
10 66 22 24 32 12 12 12 12 12 12 12 12 48 71 67 67 67 72 27 68 10 10 66 27 77 78 78 84 65 39 51 51 51 46 33 24 32 12 26 12 12 33 24 32 48 68 10
10 66 35 12 26 12 12 12 12 12 26 26 12 37 51 51 51 51 51 41 68 10 10 66 27 71 67 67 68 73 74 74 74 65 35 44 58 43 12 12 12 12 44 58 58 60 68 10
10 66 57 58 43 12 26 12 12 12 12 12 12 48 64 74 74 74 74 74 75 10 10 66 39 51 51 17 68 10 10 10 10 66 35 48 76 57 58 58 43 26 48 64 74 74 75 10
10 73 74 65 57 58 58 58 43 26 12 44 58 60 68 10 10 10 10 10 10 10 10 73 74 86 79 27 68 10 10 10 10 66 35 48 90 78 78 91 57 58 60 68 10 10 10 10
10 10 10 73 74 74 74 65 57 58 58 60 64 74 75 10 10 10 10 10 10 10 10 10 10 66 72 27 68 10 10 10 10 66 35 48 71 67 67 85 74 74 74 75 10 10 10 10
10 10 10 10 10 10 10 73 74 74 74 74 75 10 10 10 10 10 10 10 10 10 10 10 10 66 15 41 68 10 10 10 10 66 57 55 51 19 25 68 10 10 10 10 10 10 10 10
10 10 10 10 10 10 10 10 10 10 10 10 10 10 10 10 10 10 10 10 10 10 10 10 10 66 27 64 75 10 10 10 10 73 74 74 65 35 48 68 10 10 10 10 10 10 10 10
10 10 10 10 10 10 10 10 10 10 10 10 10 10 10 10 10 10 61 62 62 62 62 62 94 70 27 68 10 10 10 10 10 10 10 10 66 35 48 68 10 61 62 62 62 62 62 63
10 61 62 62 62 62 63 10 10 10 10 10 10 10 10 10 10 10 66 67 67 67 67 67 80 72 27 68 10 10 10 10 10 10 10 10 66 35 48 69 62 70 67 67 67 67 67 68
61 70 67 67 67 67 69 63 10 10 10 61 62 62 62 62 62 62 70 22 24 24 24 25 80 50 41 95 62 62 62 62 62 62 62 62 83 35 48 71 67 72 22 24 24 24 25 68
66 72 22 24 24 25 71 69 62 62 62 83 67 67 67 67 67 67 72 35 12 26 12 48 90 78 84 92 67 67 67 67 67 67 67 67 80 35 33 24 24 24 32 12 12 12 48 68
66 22 32 12 12 33 25 71 67 67 67 80 22 24 24 24 24 24 24 32 12 12 12 48 71 67 68 66 22 24 24 24 24 24 24 25 80 57 58 58 58 58 58 58 58 43 48 68
66 35 26 12 12 12 33 24 24 24 25 81 35 44 58 58 58 58 43 12 26 44 58 55 19 25 69 70 35 44 58 58 58 58 43 48 90 78 78 84 86 78 78 78 79 35 48 68
66 35 12 26 12 12 44 58 58 43 48 82 35 48 64 74 74 65 57 58 58 60 64 65 35 48 71 72 35 48 77 84 74 65 35 48 71 67 67 68 66 67 67 67 72 35 48 68
66 57 43 12 12 44 60 64 65 35 33 24 32 48 68 10 10 73 74 74 74 74 75 66 35 33 24 24 32 48 71 68 10 66 35 33 24 24 25 69 70 22 24 24 24 32 48 68
73 65 57 58 58 60 64 75 66 35 44 58 58 60 68 10 10 10 10 10 10 10 10 66 57 58 58 43 12 33 25 68 10 66 57 58 58 43 48 71 72 35 44 58 58 58 60 68
10 73 74 74 74 74 75 10 66 57 60 64 74 74 75 10 10 10 10 10 10 10 10 73 74 74 65 35 12 12 48 68 10 73 74 74 65 35 33 24 24 32 48 64 74 74 74 75
10 10 10 10 10 10 10 10 73 74 74 75 10 10 10 10 10 10 10 10 10 10 10 10 10 10 66 57 58 58 60 68 10 10 10 10 66 57 58 58 58 58 60 68 10 10 10 10
10 10 10 10 10 10 10 10 10 10 10 10 10 10 10 10 10 10 10 10 10 10 10 10 10 10 73 74 74 74 74 75 10 10 10 10 73 74 74 74 74 74 74 75 10 10 10 10
