13 13 13 10 10 13 13 13 13 13 13 10 10 13 13 13 13 13 13 10 10 13 13 13 13 13 13 10 10 13 13 13
13 13 13 10 10 13 13 13 13 13 13 10 10 13 13 13 11 13 13 10 10 13 13 13 13 13 13 10 10 13 13 13
13 13 13 10 10 13 13 13 13 13 13 10 10 13 13 13 13 13 13 10 10 13 12 13 13 13 13 10 10 13 13 13
13 13 13 10 10 13 13 13 13 13 13 10 10 13 13 13 13 13 13 10 10 13 13 13 13 13 13 10 10 13 13 13
13 13 13 10 10 13 14 13 14 13 13 10 10 13 13 13 13 13 13 10 10 14 14 14 14 13 13 10 10 13 13 13
13 13 13 10 11 13 14 13 14 13 13 10 10 13 13 13 13 13 13 10 10 13 13 14 13 13 13 10 10 13 13 13
13 13 13 10 10 13 14 13 11 13 13 10 10 13 13 13 13 13 13 10 10 13 14 13 13 13 13 10 10 13 13 13
13 13 13 12 10 13 14 13 15 13 13 10 10 13 13 13 13 13 13 10 10 14 14 14 14 13 13 10 10 13 13 13
13 13 13 10 10 13 13 13 15 13 13 10 10 13 13 13 13 13 13 10 12 13 13 13 13 13 13 10 10 13 13 13
13 13 13 10 10 13 15 15 15 13 13 10 10 13 13 13 13 13 13 10 10 13 13 13 13 13 13 10 10 13 13 13
13 13 13 10 10 13 13 13 13 13 13 10 10 13 13 13 13 13 13 10 10 13 13 13 13 13 13 10 10 13 13 13
13 13 13 10 10 13 13 13 13 13 13 10 10 13 13 13 13 13 13 10 10 13 13 13 13 13 13 10 10 13 13 13
13 13 13 10 10 13 13 13 13 13 13 10 10 13 13 13 13 13 13 10 10 13 13 13 13 13 13 10 10 13 13 13
13 13 13 10 10 13 13 13 13 13 13 10 10 13 13 13 13 13 13 10 10 13 13 13 13 13 13 10 10 13 13 13
13 13 13 10 10 13 13 13 13 13 13 10 10 13 13 13 13 13 13 10 10 13 13 13 13 13 13 10 10 13 13 13
13 13 13 10 10 13 13 13 13 13 13 10 10 13 13 13 13 13 13 10 10 13 13 13 13 13 13 10 10 13 13 13
13 13 13 10 10 13 14 14 14 13 13 10 10 13 13 13 13 13 13 10 10 13 13 13 13 13 13 10 10 13 13 13
13 13 13 10 10 13 13 13 14 13 13 10 10 13 13 13 13 13 13 10 10 13 13 14 13 13 13 10 10 13 13 13
13 13 13 10 10 13 14 14 14 13 13 10 10 13 13 13 13 13 13 10 10 13 14 14 13 13 13 10 10 13 13 13
13 13 13 10 10 13 13 13 14 13 13 10 10 13 13 13 13 13 13 10 10 14 14 14 14 13 13 10 10 13 13 13
13 13 13 10 10 13 14 14 14 13 13 10 10 13 13 13 13 13 13 10 10 13 13 14 13 13 13 10 10 13 13 13
13 13 13 10 10 13 13 13 13 13 13 10 10 13 13 13 13 13 13 10 10 13 13 14 13 13 13 10 10 13 13 13
13 13 13 10 10 13 13 13 13 13 13 10 10 13 13 13 13 13 13 10 10 13 13 13 13 13 13 10 10 13 13 13
13 13 13 10 10 13 13 13 13 13 13 10 10 13 13 13 13 13 13 10 10 13 13 13 13 13 13 10 10 13 13 13
